xfk	xfk
gjr	gjr
kpu	kpu
pjb	pjb
wbp	wbp
fhl	fhl
ubh	ubh
phy	phy
hqv	hqv
ccv	ccv
hhh	hhh
ohp	ohp
svw	svw
mci	mci
jpt	jpt
sej	sej
nth	nth
pav	pav
ekc	ekc
oup	oup
wsi	wsi
hhd	hhd
dhj	dhj
faa	faa
ocp	ocp
srd	srd
prx	prx
zuw	zuw
uoc	uoc
vrk	vrk
fyc	fyc
epb	epb
dfq	dfq
rxl	rxl
zgj	zgj
iia	iia
drt	drt
uan	uan
qse	qse
tbo	tbo
nwx	nwx
prg	prg
zar	zar
xsi	xsi
wcr	wcr
vlh	vlh
buw	buw
onl	onl
gbv	gbv
jzd	jzd
iug	iug
ejq	ejq
rec	rec
aoy	aoy
fqz	fqz
utc	utc
irw	irw
myb	myb
mhz	mhz
nbb	nbb
gdf	gdf
mks	mks
uso	uso
mqc	mqc
jdi	jdi
mbz	mbz
knu	knu
ykg	ykg
kfx	kfx
bou	bou
ipm	ipm
num	num
qmc	qmc
umj	umj
ubq	ubq
gyf	gyf
lql	lql
elp	elp
igh	igh
hes	hes
dob	dob
anu	anu
inw	inw
nof	nof
xow	xow
rjo	rjo
qfz	qfz
pvm	pvm
plq	plq
lhh	lhh
qfu	qfu
scz	scz
nzi	nzi
vtd	vtd
geo	geo
nrn	nrn
pgm	pgm
rhv	rhv
ldy	ldy
cqd	cqd
qlg	qlg
ows	ows
lww	lww
rgg	rgg
jfp	jfp
vgf	vgf
juu	juu
dgq	dgq
waz	waz
czq	czq
rxd	rxd
ptg	ptg
vjf	vjf
nvz	nvz
grf	grf
lzy	lzy
xip	xip
ffn	ffn
xln	xln
ppw	ppw
qpy	qpy
keu	keu
oet	oet
gnf	gnf
lva	lva
bug	bug
xce	xce
ztw	ztw
hmi	hmi
psq	psq
xme	xme
mkt	mkt
hgx	hgx
nhv	nhv
ufi	ufi
npd	npd
hyz	hyz
lzp	lzp
klj	klj
wrk	wrk
rdw	rdw
rtn	rtn
xsl	xsl
roc	roc
wnq	wnq
sth	sth
lny	lny
ebx	ebx
sai	sai
act	act
otv	otv
uet	uet
wxb	wxb
fwu	fwu
qav	qav
krq	krq
yci	yci
wik	wik
pgx	pgx
wqu	wqu
qip	qip
qqm	qqm
cue	cue
iyn	iyn
upq	upq
mmt	mmt
ljh	ljh
zgr	zgr
ppy	ppy
zkl	zkl
wdg	wdg
wev	wev
djr	djr
swh	swh
xyg	xyg
gvm	gvm
ick	ick
bfk	bfk
pwi	pwi
dpq	dpq
wel	wel
wao	wao
avw	avw
buv	buv
lyb	lyb
anv	anv
hef	hef
mhj	mhj
jco	jco
fby	fby
pkx	pkx
rrx	rrx
tbq	tbq
vdc	vdc
bor	bor
jon	jon
nwi	nwi
tgv	tgv
eew	eew
ycs	ycs
hie	hie
tob	tob
qcr	qcr
qth	qth
nts	nts
pcr	pcr
xqw	xqw
axq	axq
fby	fby
xaf	xaf
dqz	dqz
vuu	vuu
bcr	bcr
frw	frw
whj	whj
lwr	lwr
jjo	jjo
vhn	vhn
tui	tui
olr	olr
uay	uay
xfx	xfx
tgb	tgb
qas	qas
bag	bag
vfe	vfe
hsw	hsw
hcd	hcd
zpk	zpk
xje	xje
nfi	nfi
jbf	jbf
tjp	tjp
brl	brl
wju	wju
jec	jec
heg	heg
kpo	kpo
pqa	pqa
zqu	zqu
gco	gco
fqv	fqv
shj	shj
ekb	ekb
loy	loy
kei	kei
vgu	vgu
vvu	vvu
dzl	dzl
zwm	zwm
nor	nor
eub	eub
jsa	jsa
wud	wud
qtm	qtm
vwq	vwq
jim	jim
jdn	jdn
mem	mem
cxr	cxr
ghh	ghh
gym	gym
ayv	ayv
lho	lho
moa	moa
neo	neo
oow	oow
qfq	qfq
rvt	rvt
ikw	ikw
lqi	lqi
cyb	cyb
xel	xel
pac	pac
cvf	cvf
ncg	ncg
idp	idp
cmf	cmf
xia	xia
egu	egu
zvh	zvh
mrc	mrc
uvy	uvy
dvn	dvn
wkw	wkw
cxf	cxf
odi	odi
ghz	ghz
ddf	ddf
kvn	kvn
zqc	zqc
qze	qze
zsq	zsq
onc	onc
rfj	rfj
mgh	mgh
bjm	bjm
qno	qno
tvt	tvt
wyt	wyt
yuk	yuk
jeo	jeo
vbv	vbv
wzf	wzf
lif	lif
rvf	rvf
akl	akl
ptp	ptp
gnj	gnj
ixr	ixr
vvs	vvs
gjr	gjr
ygh	ygh
axz	axz
iwf	iwf
nnb	nnb
tij	tij
nlr	nlr
hjv	hjv
jlx	jlx
vmj	vmj
txm	txm
fiu	fiu
hkj	hkj
ndb	ndb
pta	pta
orq	orq
pzc	pzc
qlj	qlj
lqk	lqk
gov	gov
guq	guq
nit	nit
oqz	oqz
zyn	zyn
rep	rep
vcb	vcb
kdv	kdv
xwm	xwm
qfd	qfd
mwd	mwd
dyu	dyu
mls	mls
zxi	zxi
vnl	vnl
ksr	ksr
bmj	bmj
jvc	jvc
xnk	xnk
ayp	ayp
vvz	vvz
frq	frq
vke	vke
yqi	yqi
myr	myr
eyj	eyj
kla	kla
zmm	zmm
fef	fef
gwz	gwz
coz	coz
vcg	vcg
zcp	zcp
dmk	dmk
oqx	oqx
aeq	aeq
jmb	jmb
coo	coo
jwh	jwh
kbz	kbz
fyq	fyq
tfm	tfm
bax	bax
uxb	uxb
fmx	fmx
nbr	nbr
sgh	sgh
vxh	vxh
rqs	rqs
dsi	dsi
fqd	fqd
fht	fht
rlt	rlt
pbb	pbb
cay	cay
iag	iag
pco	pco
xhp	xhp
eon	eon
hhl	hhl
sgj	sgj
qqo	qqo
tty	tty
cgq	cgq
bpb	bpb
cil	cil
rlw	rlw
pns	pns
cca	cca
zkx	zkx
scd	scd
zwt	zwt
sjc	sjc
lkg	lkg
eli	eli
ugl	ugl
wmk	wmk
nbs	nbs
sea	sea
cho	cho
eyn	eyn
gys	gys
kce	kce
jan	jan
cxg	cxg
puj	puj
yft	yft
yah	yah
ofz	ofz
ydm	ydm
ari	ari
cbv	cbv
hfc	hfc
gmp	gmp
lsu	lsu
osu	osu
vcz	vcz
ktr	ktr
rnp	rnp
umu	umu
sdg	sdg
nsf	nsf
ysi	ysi
evg	evg
knn	knn
fnc	fnc
sdw	sdw
rsv	rsv
gix	gix
haj	haj
oqb	oqb
pll	pll
mjr	mjr
onn	onn
jqi	jqi
jab	jab
enw	enw
ezz	ezz
wtd	wtd
cal	cal
iyd	iyd
ifp	ifp
lzg	lzg
ozj	ozj
lnc	lnc
vsw	vsw
sws	sws
oer	oer
mxf	mxf
fbc	fbc
oex	oex
fkl	fkl
cdl	cdl
oyz	oyz
szu	szu
fqx	fqx
lnm	lnm
wri	wri
dbh	dbh
jxe	jxe
gib	gib
xqm	xqm
mry	mry
jxa	jxa
skf	skf
ysk	ysk
xxb	xxb
erj	erj
lal	lal
tqh	tqh
cbz	cbz
fhf	fhf
cqt	cqt
vst	vst
aiu	aiu
zwz	zwz
fyv	fyv
dcr	dcr
qsl	qsl
onl	onl
toc	toc
eoq	eoq
cpb	cpb
kwm	kwm
nvp	nvp
uyp	uyp
lwd	lwd
mvh	mvh
nyz	nyz
ifs	ifs
jnh	jnh
rox	rox
yht	yht
yne	yne
phg	phg
bob	bob
eed	eed
sou	sou
tpz	tpz
yat	yat
hxu	hxu
dfu	dfu
aps	aps
hro	hro
wja	wja
pax	pax
evm	evm
rga	rga
bmw	bmw
was	was
ipr	ipr
ole	ole
uwv	uwv
hxk	hxk
cwj	cwj
nye	nye
cpg	cpg
mht	mht
bih	bih
fql	fql
efr	efr
yas	yas
gwo	gwo
rui	rui
nrd	nrd
wxy	wxy
qxq	qxq
ajy	ajy
vwx	vwx
nsa	nsa
bhf	bhf
imf	imf
ijh	ijh
ors	ors
zpq	zpq
ddu	ddu
bmp	bmp
crd	crd
fwn	fwn
sji	sji
szm	szm
jzq	jzq
djv	djv
zxp	zxp
aqp	aqp
kwa	kwa
pbd	pbd
rxa	rxa
xhy	xhy
vwf	vwf
aqi	aqi
aqm	aqm
fsa	fsa
mdm	mdm
qoe	qoe
yqk	yqk
jdi	jdi
ped	ped
kup	kup
kna	kna
oty	oty
lxu	lxu
eof	eof
obp	obp
gdo	gdo
yby	yby
mvq	mvq
kdr	kdr
ilc	ilc
dke	dke
dah	dah
ywj	ywj
mip	mip
hbf	hbf
ekz	ekz
czw	czw
lss	lss
any	any
ird	ird
kqe	kqe
fdl	fdl
ivh	ivh
hhx	hhx
she	she
aef	aef
smm	smm
akc	akc
ryj	ryj
wot	wot
tar	tar
uiu	uiu
ued	ued
dpu	dpu
eug	eug
wus	wus
iaj	iaj
brz	brz
cos	cos
zfq	zfq
zyb	zyb
yft	yft
vqv	vqv
iog	iog
wou	wou
vyx	vyx
qmh	qmh
rih	rih
rfq	rfq
yhj	yhj
vzp	vzp
kpe	kpe
hlz	hlz
lzj	lzj
qfc	qfc
zrb	zrb
vfx	vfx
lng	lng
mgm	mgm
cfw	cfw
yzv	yzv
jvg	jvg
kjh	kjh
osn	osn
ajw	ajw
jvo	jvo
pkm	pkm
xaf	xaf
jyu	jyu
whz	whz
iyx	iyx
rns	rns
tlz	tlz
dkc	dkc
wuf	wuf
vmi	vmi
ilo	ilo
cml	cml
evg	evg
yyn	yyn
ozf	ozf
ajy	ajy
mji	mji
gkr	gkr
ygx	ygx
qid	qid
plm	plm
kxf	kxf
uuf	uuf
igv	igv
hnc	hnc
vre	vre
zcn	zcn
rbk	rbk
wbw	wbw
mhj	mhj
njf	njf
jxt	jxt
fic	fic
ohv	ohv
ahk	ahk
hov	hov
xup	xup
axc	axc
vlu	vlu
yph	yph
eis	eis
eiv	eiv
qih	qih
ffd	ffd
pnd	pnd
jup	jup
pux	pux
qll	qll
urw	urw
tsa	tsa
sot	sot
ysr	ysr
xpq	xpq
nxv	nxv
rqr	rqr
nlm	nlm
zse	zse
xpx	xpx
qip	qip
fls	fls
npg	npg
zas	zas
ubh	ubh
ftk	ftk
hgo	hgo
zzl	zzl
rff	rff
obz	obz
xcn	xcn
hlc	hlc
uho	uho
som	som
phk	phk
mnh	mnh
jku	jku
ing	ing
vtl	vtl
mpm	mpm
toa	toa
ygp	ygp
txk	txk
qbh	qbh
xex	xex
ocp	ocp
kxf	kxf
xkt	xkt
vso	vso
dpn	dpn
hyr	hyr
ygn	ygn
sdy	sdy
hju	hju
fbc	fbc
fjz	fjz
tln	tln
rkq	rkq
qjl	qjl
qyr	qyr
jyf	jyf
ztc	ztc
iww	iww
rmm	rmm
wmr	wmr
kqj	kqj
zck	zck
ikg	ikg
hzl	hzl
btg	btg
ekj	ekj
zjf	zjf
uea	uea
jbx	jbx
hmz	hmz
jqm	jqm
wor	wor
fdl	fdl
jvw	jvw
mhd	mhd
avo	avo
oty	oty
lpk	lpk
qco	qco
tyx	tyx
lbo	lbo
ukn	ukn
pwz	pwz
arr	arr
pna	pna
ohu	ohu
dfe	dfe
aen	aen
dft	dft
jru	jru
tyg	tyg
jcr	jcr
qzk	qzk
cge	cge
oik	oik
jyf	jyf
seo	seo
tdg	tdg
lzw	lzw
kaj	kaj
ewz	ewz
wqn	wqn
pfl	pfl
csd	csd
eok	eok
gzo	gzo
gci	gci
ekc	ekc
kch	kch
rkc	rkc
lhc	lhc
ehm	ehm
uxt	uxt
qzz	qzz
gos	gos
bhv	bhv
kct	kct
umx	umx
rmg	rmg
wum	wum
sdg	sdg
vjy	vjy
pop	pop
drk	drk
vue	vue
ulh	ulh
scl	scl
wqy	wqy
zrj	zrj
frj	frj
fyw	fyw
oba	oba
xwd	xwd
icw	icw
xub	xub
ije	ije
rjk	rjk
dbv	dbv
kaq	kaq
jnv	jnv
wty	wty
xzw	xzw
whn	whn
yss	yss
rnn	rnn
tma	tma
abk	abk
gyu	gyu
qqr	qqr
esa	esa
gfc	gfc
fda	fda
dka	dka
aup	aup
wnq	wnq
ohd	ohd
ikx	ikx
lmm	lmm
dvs	dvs
iym	iym
ghq	ghq
ell	ell
fli	fli
aib	aib
kuz	kuz
vrv	vrv
ptz	ptz
xyd	xyd
iiq	iiq
zoa	zoa
byi	byi
lel	lel
nks	nks
iab	iab
rzp	rzp
hrz	hrz
nxx	nxx
hzo	hzo
ips	ips
ofa	ofa
dfz	dfz
zat	zat
lqt	lqt
nrq	nrq
xdy	xdy
pmx	pmx
yao	yao
uak	uak
nhf	nhf
lmd	lmd
xvm	xvm
jdw	jdw
sjf	sjf
hpy	hpy
yvc	yvc
zed	zed
erz	erz
aac	aac
rbe	rbe
vxt	vxt
kqv	kqv
zev	zev
pkm	pkm
igc	igc
mzr	mzr
mrm	mrm
lyz	lyz
hcl	hcl
efd	efd
cos	cos
wsh	wsh
bch	bch
fjh	fjh
sus	sus
ldm	ldm
ber	ber
pbm	pbm
hre	hre
sad	sad
yup	yup
zob	zob
ssl	ssl
dqz	dqz
tyn	tyn
dfq	dfq
nsz	nsz
dev	dev
dyx	dyx
jqw	jqw
yed	yed
czl	czl
hhe	hhe
zsy	zsy
oxw	oxw
ezo	ezo
cfy	cfy
snx	snx
gdy	gdy
zqe	zqe
jbl	jbl
kir	kir
wwv	wwv
pdc	pdc
pcd	pcd
xqh	xqh
ghi	ghi
szg	szg
bfh	bfh
htq	htq
bms	bms
fep	fep
end	end
rst	rst
onc	onc
hzj	hzj
vqp	vqp
lsc	lsc
tyy	tyy
tiy	tiy
dsf	dsf
ain	ain
eww	eww
xdl	xdl
pix	pix
kmi	kmi
bug	bug
ywl	ywl
atu	atu
cdw	cdw
bmo	bmo
wph	wph
cna	cna
knq	knq
ijn	ijn
axk	axk
foi	foi
yje	yje
oii	oii
gfv	gfv
zbi	zbi
ylm	ylm
dqn	dqn
yve	yve
hpv	hpv
qlg	qlg
uog	uog
xlz	xlz
bjz	bjz
ioh	ioh
rwe	rwe
aax	aax
abj	abj
zkt	zkt
icd	icd
yww	yww
lna	lna
cki	cki
rsj	rsj
awe	awe
fmg	fmg
ivk	ivk
pzw	pzw
zoa	zoa
bzv	bzv
ghl	ghl
ths	ths
fae	fae
dut	dut
wni	wni
ush	ush
ews	ews
wbn	wbn
jeu	jeu
vfi	vfi
ibg	ibg
jsw	jsw
khr	khr
yhb	yhb
whg	whg
btk	btk
naz	naz
jhy	jhy
ymg	ymg
vir	vir
btj	btj
pfu	pfu
iig	iig
cgd	cgd
yck	yck
zaa	zaa
hem	hem
hlh	hlh
psy	psy
yqp	yqp
ldc	ldc
yxv	yxv
nae	nae
rbd	rbd
lcy	lcy
edq	edq
lss	lss
edv	edv
bxo	bxo
jim	jim
qws	qws
gtn	gtn
ico	ico
kfe	kfe
vrb	vrb
ren	ren
kpp	kpp
lix	lix
vsn	vsn
sqf	sqf
sxf	sxf
gps	gps
toq	toq
iqx	iqx
lpd	lpd
wvs	wvs
quv	quv
ozk	ozk
hej	hej
pgs	pgs
ptz	ptz
dqj	dqj
dgt	dgt
yyw	yyw
pzr	pzr
llj	llj
ahq	ahq
miu	miu
nxc	nxc
lfv	lfv
taw	taw
aqh	aqh
dtp	dtp
gvq	gvq
bkf	bkf
wjb	wjb
mzj	mzj
vgj	vgj
igi	igi
ldg	ldg
maq	maq
wiq	wiq
xxs	xxs
dqd	dqd
vdi	vdi
npi	npi
bde	bde
qqp	qqp
ghp	ghp
pks	pks
xun	xun
bxk	bxk
wgb	wgb
wiz	wiz
mzx	mzx
dep	dep
vwz	vwz
cko	cko
pzm	pzm
kyj	kyj
wtd	wtd
ekh	ekh
igj	igj
tgg	tgg
faa	faa
xoi	xoi
cfu	cfu
anq	anq
rlf	rlf
qxu	qxu
jhu	jhu
kfk	kfk
ebp	ebp
tem	tem
tek	tek
dyj	dyj
eou	eou
pdk	pdk
vcm	vcm
xlf	xlf
gez	gez
oex	oex
xak	xak
img	img
org	org
wxt	wxt
mxz	mxz
gcc	gcc
xaf	xaf
lix	lix
nti	nti
wti	wti
qso	qso
njj	njj
spk	spk
kyw	kyw
nak	nak
obn	obn
cad	cad
ouv	ouv
klu	klu
pfc	pfc
gvz	gvz
yzn	yzn
gfl	gfl
hqj	hqj
jsh	jsh
jjo	jjo
fcx	fcx
pql	pql
ume	ume
nup	nup
zux	zux
exr	exr
myf	myf
zhq	zhq
eld	eld
nye	nye
pag	pag
frk	frk
sss	sss
hud	hud
huc	huc
vph	vph
zei	zei
tre	tre
eve	eve
gkg	gkg
gtq	gtq
wlq	wlq
zum	zum
tel	tel
zzc	zzc
vsh	vsh
ksi	ksi
iug	iug
wjq	wjq
ozn	ozn
erl	erl
xtb	xtb
kxd	kxd
vrw	vrw
kcr	kcr
fgy	fgy
zxe	zxe
rmm	rmm
wzv	wzv
exn	exn
vid	vid
lar	lar
pex	pex
qpu	qpu
jos	jos
vbn	vbn
ytq	ytq
jrj	jrj
icu	icu
ans	ans
wgi	wgi
qpv	qpv
lcx	lcx
pst	pst
djs	djs
zcf	zcf
ort	ort
pjg	pjg
zpi	zpi
ffe	ffe
lav	lav
yop	yop
iae	iae
gnk	gnk
kel	kel
luk	luk
mra	mra
cwn	cwn
yzh	yzh
kwe	kwe
ltb	ltb
uks	uks
qln	qln
nar	nar
jhw	jhw
faa	faa
don	don
vyd	vyd
rce	rce
neb	neb
leg	leg
rjh	rjh
zhh	zhh
tce	tce
khj	khj
spi	spi
rkk	rkk
nko	nko
msx	msx
prx	prx
nef	nef
xrf	xrf
brr	brr
mzb	mzb
lkm	lkm
vnl	vnl
aio	aio
jvg	jvg
ajg	ajg
glw	glw
fvo	fvo
rnm	rnm
frg	frg
els	els
yeb	yeb
uwd	uwd
wbz	wbz
nug	nug
epj	epj
kmu	kmu
ape	ape
foc	foc
kft	kft
sqo	sqo
hcd	hcd
ylu	ylu
yai	yai
hgb	hgb
cmn	cmn
rtt	rtt
kzm	kzm
zry	zry
fxd	fxd
vdl	vdl
acf	acf
cgz	cgz
ced	ced
hre	hre
aih	aih
qqf	qqf
zux	zux
oxg	oxg
lvz	lvz
xeo	xeo
pwq	pwq
pgm	pgm
uqx	uqx
nce	nce
qxq	qxq
zfi	zfi
vpf	vpf
vlc	vlc
ond	ond
nuy	nuy
dle	dle
owr	owr
umh	umh
xnm	xnm
jjh	jjh
xap	xap
fin	fin
gfl	gfl
qza	qza
jgo	jgo
njy	njy
zzi	zzi
tzl	tzl
fya	fya
yeq	yeq
pit	pit
ttn	ttn
iaf	iaf
opv	opv
zdo	zdo
ado	ado
ryo	ryo
kmy	kmy
ddk	ddk
qnp	qnp
ybh	ybh
pdn	pdn
qqp	qqp
kjp	kjp
xbg	xbg
dpq	dpq
mls	mls
wds	wds
rcf	rcf
qyg	qyg
zeg	zeg
jps	jps
tud	tud
aiv	aiv
hfw	hfw
ohs	ohs
jvt	jvt
yor	yor
iya	iya
zku	zku
zrt	zrt
auy	auy
kvw	kvw
jlk	jlk
zjp	zjp
bis	bis
fxy	fxy
bjy	bjy
wvl	wvl
yyc	yyc
saw	saw
fpf	fpf
shx	shx
xxi	xxi
ukb	ukb
rrd	rrd
icj	icj
tzp	tzp
aou	aou
ujx	ujx
wyz	wyz
pfk	pfk
xqs	xqs
qtv	qtv
mqb	mqb
jka	jka
lgs	lgs
rqs	rqs
lsp	lsp
blw	blw
hzo	hzo
omm	omm
inr	inr
wtm	wtm
asu	asu
ymm	ymm
cie	cie
oyv	oyv
xka	xka
wsl	wsl
ibf	ibf
smo	smo
jrm	jrm
ziy	ziy
gde	gde
mkx	mkx
boc	boc
jyq	jyq
nau	nau
bhp	bhp
mca	mca
uii	uii
kyj	kyj
kjt	kjt
bsl	bsl
fww	fww
esx	esx
zrq	zrq
len	len
svx	svx
vli	vli
rud	rud
nqm	nqm
tbb	tbb
rwj	rwj
rbr	rbr
nab	nab
hiz	hiz
ags	ags
msn	msn
gos	gos
uas	uas
oba	oba
znu	znu
hij	hij
taw	taw
noe	noe
hvx	hvx
ebn	ebn
evv	evv
vtq	vtq
zju	zju
iia	iia
fbl	fbl
mpy	mpy
vvu	vvu
yyc	yyc
mjp	mjp
edw	edw
etd	etd
pdp	pdp
fcu	fcu
ovj	ovj
snj	snj
irs	irs
urp	urp
dcs	dcs
wnb	wnb
pbs	pbs
kpq	kpq
maj	maj
jkv	jkv
obc	obc
qbk	qbk
nte	nte
umf	umf
rog	rog
ewj	ewj
taj	taj
ncu	ncu
tjo	tjo
spm	spm
axw	axw
hmc	hmc
ovw	ovw
rtq	rtq
qyc	qyc
nsd	nsd
zji	zji
xap	xap
fjv	fjv
rhy	rhy
lzx	lzx
qpd	qpd
kuy	kuy
nep	nep
lzr	lzr
ltt	ltt
ifl	ifl
kwo	kwo
ulo	ulo
twj	twj
zdz	zdz
ufn	ufn
uco	uco
qjr	qjr
yeu	yeu
zjz	zjz
ldi	ldi
trq	trq
zrx	zrx
ehx	ehx
kat	kat
rji	rji
wda	wda
pga	pga
oyr	oyr
juo	juo
qry	qry
igv	igv
uqd	uqd
rrz	rrz
ojq	ojq
xdx	xdx
ckj	ckj
ghx	ghx
oca	oca
isx	isx
jgx	jgx
mtm	mtm
noo	noo
qsv	qsv
hqd	hqd
pcc	pcc
yru	yru
rnk	rnk
ytx	ytx
jod	jod
nxs	nxs
ila	ila
hmw	hmw
vcp	vcp
jwf	jwf
rma	rma
bcn	bcn
pxk	pxk
qaz	qaz
cfz	cfz
byl	byl
xdi	xdi
hbe	hbe
daq	daq
oel	oel
hfy	hfy
ige	ige
cmc	cmc
hvn	hvn
jgn	jgn
bgh	bgh
qtn	qtn
lwu	lwu
osb	osb
wid	wid
bev	bev
gqe	gqe
syr	syr
ocw	ocw
obu	obu
zhx	zhx
vbg	vbg
dun	dun
prb	prb
emp	emp
sup	sup
itj	itj
nxg	nxg
ren	ren
mqd	mqd
gbi	gbi
xcr	xcr
eza	eza
yms	yms
zax	zax
mea	mea
dsw	dsw
xca	xca
wya	wya
fkp	fkp
olq	olq
mxn	mxn
tcg	tcg
wfe	wfe
amk	amk
fmf	fmf
lwp	lwp
ckn	ckn
yua	yua
ubd	ubd
rir	rir
kmg	kmg
zpx	zpx
vhd	vhd
aub	aub
rdx	rdx
rar	rar
kzp	kzp
fsl	fsl
mna	mna
jxf	jxf
qyf	qyf
bqb	bqb
avz	avz
uxa	uxa
dfy	dfy
quu	quu
xaj	xaj
nez	nez
dtn	dtn
lmb	lmb
xra	xra
ubr	ubr
iim	iim
akd	akd
glj	glj
rig	rig
xin	xin
xez	xez
fpa	fpa
vqq	vqq
uyz	uyz
whx	whx
woo	woo
fil	fil
wvi	wvi
kug	kug
jvn	jvn
szt	szt
bfl	bfl
lnq	lnq
sym	sym
dte	dte
mrs	mrs
jim	jim
zop	zop
ipr	ipr
fde	fde
kgi	kgi
drv	drv
nlp	nlp
zxg	zxg
krm	krm
uzu	uzu
pnw	pnw
yiw	yiw
kez	kez
rga	rga
oyb	oyb
gnd	gnd
lpv	lpv
kts	kts
izl	izl
jbe	jbe
hqr	hqr
xdi	xdi
ppv	ppv
duk	duk
mfl	mfl
lvp	lvp
ayy	ayy
uom	uom
ogo	ogo
rxi	rxi
jmc	jmc
zhm	zhm
mrs	mrs
vpj	vpj
mte	mte
ntl	ntl
dnr	dnr
nha	nha
upt	upt
omx	omx
ppr	ppr
hty	hty
sfl	sfl
ewk	ewk
vui	vui
xgf	xgf
usq	usq
lzf	lzf
mtt	mtt
lhn	lhn
saf	saf
mko	mko
met	met
qea	qea
kfx	kfx
ebs	ebs
lng	lng
ocj	ocj
gsu	gsu
jnr	jnr
zit	zit
wld	wld
lli	lli
brp	brp
zqd	zqd
npu	npu
hms	hms
bzg	bzg
kmq	kmq
ull	ull
zcq	zcq
ovz	ovz
gui	gui
fsh	fsh
rrf	rrf
vzj	vzj
uou	uou
mtt	mtt
itl	itl
ysf	ysf
tzr	tzr
jxf	jxf
wpz	wpz
rlr	rlr
rxd	rxd
gec	gec
eic	eic
oxq	oxq
mbt	mbt
dbr	dbr
zwf	zwf
kvn	kvn
suu	suu
uve	uve
wlk	wlk
chd	chd
wuz	wuz
guf	guf
qsm	qsm
tnf	tnf
tgv	tgv
oyp	oyp
ahi	ahi
mlt	mlt
bqw	bqw
rqo	rqo
zhx	zhx
cpe	cpe
eol	eol
qud	qud
pzs	pzs
dwo	dwo
fwx	fwx
vzp	vzp
scq	scq
owb	owb
mlc	mlc
exr	exr
ygc	ygc
ceq	ceq
aud	aud
qjb	qjb
ayj	ayj
yyd	yyd
qza	qza
lbg	lbg
gzc	gzc
zen	zen
zxe	zxe
kdy	kdy
ugs	ugs
lsy	lsy
xoc	xoc
fwx	fwx
bgw	bgw
fii	fii
nbp	nbp
kjg	kjg
psc	psc
phx	phx
qsr	qsr
heh	heh
vxd	vxd
huc	huc
yhe	yhe
fux	fux
mjc	mjc
qhz	qhz
koe	koe
sdv	sdv
utn	utn
tag	tag
omp	omp
ogs	ogs
tuc	tuc
qri	qri
yrx	yrx
pyq	pyq
xyy	xyy
bme	bme
pbt	pbt
uou	uou
via	via
ehi	ehi
gyh	gyh
lsn	lsn
xwr	xwr
sup	sup
yvw	yvw
wfz	wfz
wws	wws
wig	wig
xie	xie
rww	rww
psj	psj
uik	uik
tps	tps
rcw	rcw
qlu	qlu
blj	blj
zvl	zvl
eww	eww
olw	olw
vwy	vwy
gwo	gwo
nyr	nyr
lfx	lfx
wvz	wvz
dyj	dyj
fyv	fyv
ixw	ixw
vrp	vrp
jfg	jfg
ugx	ugx
wih	wih
krp	krp
hzu	hzu
fpy	fpy
aka	aka
pbb	pbb
trh	trh
keh	keh
xjr	xjr
qcy	qcy
whk	whk
foj	foj
mrt	mrt
cag	cag
vtc	vtc
hrb	hrb
ruc	ruc
hym	hym
fdc	fdc
psg	psg
nau	nau
yzd	yzd
bna	bna
pic	pic
zme	zme
vrl	vrl
vrm	vrm
bqw	bqw
obt	obt
ljv	ljv
pnq	pnq
vtd	vtd
krl	krl
hct	hct
ryl	ryl
yut	yut
yvn	yvn
eul	eul
ooo	ooo
mrp	mrp
tan	tan
tdk	tdk
iny	iny
bfu	bfu
dir	dir
way	way
jyy	jyy
xdm	xdm
syg	syg
aur	aur
iyw	iyw
yvk	yvk
zun	zun
bhq	bhq
ada	ada
ixu	ixu
fkz	fkz
byw	byw
qjo	qjo
stm	stm
clj	clj
jry	jry
msh	msh
ptl	ptl
tem	tem
ylt	ylt
qos	qos
hoa	hoa
yqi	yqi
xfj	xfj
mrh	mrh
hbc	hbc
igf	igf
tlm	tlm
olp	olp
iys	iys
ujm	ujm
box	box
fed	fed
tyd	tyd
aet	aet
vkj	vkj
emu	emu
kew	kew
zie	zie
pcf	pcf
hjz	hjz
rik	rik
xxq	xxq
vzd	vzd
gfh	gfh
bas	bas
aqi	aqi
irz	irz
blg	blg
bud	bud
uzc	uzc
rjt	rjt
amg	amg
veq	veq
bnn	bnn
sbm	sbm
eaf	eaf
ofs	ofs
eks	eks
czy	czy
ujs	ujs
pcz	pcz
exx	exx
jgv	jgv
czg	czg
cbt	cbt
lii	lii
bam	bam
iaz	iaz
bgv	bgv
xhm	xhm
sys	sys
rgw	rgw
bjb	bjb
plc	plc
nmo	nmo
zzm	zzm
uww	uww
fwc	fwc
kcd	kcd
xkb	xkb
bgc	bgc
kqo	kqo
xvh	xvh
usd	usd
bub	bub
fxs	fxs
ref	ref
zle	zle
qsl	qsl
asf	asf
sgo	sgo
jdq	jdq
hva	hva
rns	rns
bib	bib
dbo	dbo
zzg	zzg
nvp	nvp
icl	icl
otb	otb
svm	svm
jka	jka
ton	ton
jhh	jhh
ezw	ezw
bnh	bnh
yho	yho
oyo	oyo
jfv	jfv
xay	xay
veh	veh
vhp	vhp
dox	dox
rco	rco
qhr	qhr
jpj	jpj
foo	foo
pyj	pyj
smg	smg
nze	nze
sts	sts
whh	whh
mcc	mcc
glg	glg
akc	akc
pho	pho
ikp	ikp
fka	fka
shs	shs
wwc	wwc
yxd	yxd
jjz	jjz
crv	crv
qwp	qwp
hvs	hvs
zhv	zhv
ybd	ybd
cfk	cfk
oqm	oqm
nbw	nbw
hbd	hbd
yqc	yqc
rrz	rrz
kcg	kcg
kzw	kzw
exb	exb
tax	tax
iza	iza
fqr	fqr
vob	vob
yyz	yyz
jzn	jzn
vna	vna
qvq	qvq
rwg	rwg
tzq	tzq
lwg	lwg
frv	frv
qfm	qfm
qel	qel
gux	gux
yfb	yfb
fli	fli
liw	liw
how	how
yxj	yxj
xzo	xzo
dac	dac
bik	bik
uih	uih
hlt	hlt
ecq	ecq
onf	onf
mqw	mqw
sen	sen
jvk	jvk
aji	aji
htb	htb
snn	snn
pdb	pdb
wzp	wzp
mxl	mxl
yww	yww
bsk	bsk
puv	puv
phm	phm
exo	exo
bfz	bfz
wbv	wbv
rkj	rkj
qqr	qqr
wax	wax
zsf	zsf
xve	xve
gwm	gwm
ahn	ahn
dbt	dbt
bxe	bxe
lap	lap
cwo	cwo
oyc	oyc
fyg	fyg
vkk	vkk
afv	afv
mhy	mhy
oco	oco
nza	nza
wwu	wwu
zgb	zgb
mcb	mcb
ylj	ylj
zsd	zsd
sqo	sqo
qnr	qnr
oww	oww
vco	vco
mlq	mlq
iaa	iaa
jdz	jdz
kqu	kqu
pqy	pqy
cse	cse
mgz	mgz
tpp	tpp
xcy	xcy
asw	asw
adb	adb
jeo	jeo
rvn	rvn
gtz	gtz
wtn	wtn
niq	niq
bfb	bfb
ykh	ykh
xmu	xmu
ave	ave
zoo	zoo
yce	yce
tnq	tnq
fvd	fvd
fts	fts
xki	xki
xad	xad
vqw	vqw
irx	irx
roo	roo
aot	aot
zdf	zdf
yvw	yvw
uyh	uyh
wla	wla
lel	lel
ykd	ykd
une	une
bea	bea
vhc	vhc
oto	oto
aaj	aaj
aug	aug
oay	oay
yng	yng
pfo	pfo
bof	bof
mal	mal
yfj	yfj
zda	zda
wxy	wxy
cgk	cgk
nwg	nwg
mgk	mgk
hso	hso
ilz	ilz
kpl	kpl
ftg	ftg
tqh	tqh
ztl	ztl
wih	wih
axj	axj
egk	egk
rue	rue
dzz	dzz
efe	efe
oxr	oxr
bzb	bzb
ozv	ozv
lzt	lzt
yto	yto
hyt	hyt
udb	udb
rfw	rfw
fdq	fdq
qji	qji
kug	kug
lnz	lnz
ane	ane
cpy	cpy
zlx	zlx
vst	vst
bxf	bxf
ufz	ufz
eqk	eqk
emk	emk
rrq	rrq
wwv	wwv
lbc	lbc
xfb	xfb
jzh	jzh
jse	jse
oeb	oeb
kxt	kxt
mrb	mrb
xer	xer
rdh	rdh
dok	dok
his	his
jwu	jwu
tpj	tpj
rjq	rjq
yix	yix
ojp	ojp
vyi	vyi
olq	olq
san	san
xou	xou
xar	xar
eqd	eqd
hip	hip
dns	dns
scd	scd
niv	niv
jea	jea
brr	brr
jxf	jxf
bpb	bpb
wsg	wsg
hug	hug
nbk	nbk
vow	vow
wfe	wfe
ifc	ifc
yvl	yvl
jpl	jpl
ygf	ygf
rfa	rfa
ezt	ezt
xfb	xfb
ogi	ogi
bau	bau
fbz	fbz
bth	bth
mwf	mwf
prk	prk
kav	kav
pir	pir
ixv	ixv
oah	oah
jjs	jjs
ygg	ygg
pns	pns
tih	tih
ipw	ipw
nhp	nhp
ujk	ujk
jky	jky
wub	wub
awo	awo
pmq	pmq
iqr	iqr
vit	vit
hmf	hmf
zog	zog
irj	irj
uzo	uzo
tud	tud
bdl	bdl
gok	gok
qgi	qgi
lgy	lgy
eiw	eiw
yjk	yjk
upa	upa
jno	jno
xpz	xpz
ilh	ilh
zgo	zgo
tfq	tfq
zig	zig
fuy	fuy
owq	owq
pfn	pfn
ojq	ojq
rog	rog
knn	knn
mng	mng
fbc	fbc
iiz	iiz
pin	pin
rot	rot
njv	njv
ngr	ngr
web	web
iif	iif
cum	cum
fqt	fqt
yxh	yxh
bpk	bpk
uwy	uwy
mvz	mvz
udq	udq
euv	euv
fdq	fdq
dpi	dpi
pbh	pbh
hoe	hoe
iiq	iiq
yij	yij
xyi	xyi
bjv	bjv
tbt	tbt
wpw	wpw
thl	thl
zui	zui
ies	ies
ejc	ejc
uhg	uhg
wbs	wbs
xuv	xuv
bjd	bjd
jmg	jmg
giv	giv
eqk	eqk
wtu	wtu
wfz	wfz
eik	eik
ppd	ppd
wva	wva
ryz	ryz
ieo	ieo
kin	kin
fji	fji
ojv	ojv
zvw	zvw
lyp	lyp
wln	wln
jlr	jlr
zgw	zgw
cdf	cdf
gkv	gkv
eim	eim
qpw	qpw
tct	tct
rvc	rvc
psm	psm
ciy	ciy
zeu	zeu
jhc	jhc
wcp	wcp
pwm	pwm
aji	aji
rxi	rxi
qys	qys
xcv	xcv
mwp	mwp
ybw	ybw
rvc	rvc
auu	auu
bnz	bnz
rhw	rhw
uqw	uqw
rqr	rqr
gqo	gqo
kdj	kdj
uvd	uvd
bmu	bmu
zfz	zfz
urq	urq
flt	flt
jsz	jsz
hwo	hwo
gvi	gvi
pnp	pnp
efi	efi
mle	mle
rhw	rhw
ivy	ivy
iyr	iyr
hqq	hqq
tot	tot
zhj	zhj
odn	odn
fna	fna
fkm	fkm
vcx	vcx
uil	uil
paa	paa
tnh	tnh
gmh	gmh
dvb	dvb
epc	epc
vnf	vnf
ehm	ehm
fxb	fxb
fcy	fcy
hjy	hjy
hlf	hlf
ybj	ybj
gzl	gzl
voy	voy
ltx	ltx
lmp	lmp
dxz	dxz
mnn	mnn
xkq	xkq
efi	efi
zjg	zjg
vlj	vlj
lfj	lfj
jcg	jcg
xds	xds
ojr	ojr
kyh	kyh
iyp	iyp
jrx	jrx
lhb	lhb
zwl	zwl
edc	edc
oyy	oyy
abk	abk
sbh	sbh
bnx	bnx
dme	dme
igv	igv
qrg	qrg
xhh	xhh
xbx	xbx
hva	hva
cvc	cvc
gsy	gsy
lpx	lpx
skv	skv
vcp	vcp
tvp	tvp
isn	isn
zie	zie
ahc	ahc
tsy	tsy
mrw	mrw
got	got
ios	ios
ffs	ffs
hbi	hbi
mpc	mpc
voo	voo
kud	kud
oat	oat
pof	pof
jhe	jhe
izt	izt
uli	uli
yly	yly
gev	gev
wgd	wgd
zyf	zyf
swn	swn
dac	dac
sva	sva
upi	upi
jtq	jtq
daf	daf
hsc	hsc
six	six
djt	djt
umr	umr
mop	mop
nge	nge
cai	cai
swf	swf
dqn	dqn
wks	wks
gna	gna
dzc	dzc
nfr	nfr
wiv	wiv
ehz	ehz
wza	wza
iyv	iyv
tdt	tdt
bqe	bqe
nlg	nlg
gwi	gwi
wjs	wjs
vzg	vzg
uqa	uqa
rja	rja
ekh	ekh
ivs	ivs
iqm	iqm
ech	ech
nsf	nsf
kyt	kyt
yll	yll
ldz	ldz
xfh	xfh
mao	mao
mxs	mxs
wek	wek
ehy	ehy
pja	pja
pbu	pbu
axu	axu
kyw	kyw
ypu	ypu
kap	kap
uhz	uhz
nqx	nqx
uld	uld
lav	lav
lys	lys
mqi	mqi
rrc	rrc
qzj	qzj
pya	pya
cob	cob
ozu	ozu
ogy	ogy
yfv	yfv
gjs	gjs
oqf	oqf
hxt	hxt
zsv	zsv
dgy	dgy
iaq	iaq
yyr	yyr
hgy	hgy
jhe	jhe
srs	srs
rif	rif
hjj	hjj
yqb	yqb
vac	vac
knd	knd
reb	reb
tld	tld
lxb	lxb
cte	cte
aap	aap
zea	zea
bxg	bxg
jxq	jxq
fnz	fnz
hcn	hcn
lkf	lkf
bac	bac
rvl	rvl
pbs	pbs
ytr	ytr
uxi	uxi
wzm	wzm
mym	mym
glj	glj
zjn	zjn
hsk	hsk
ctr	ctr
gfj	gfj
mmi	mmi
mqx	mqx
hgb	hgb
qde	qde
fjw	fjw
lnz	lnz
shk	shk
rkn	rkn
wxf	wxf
xpv	xpv
oqw	oqw
eja	eja
zlf	zlf
bae	bae
ioz	ioz
zzl	zzl
dcl	dcl
mxx	mxx
wgm	wgm
flq	flq
vtl	vtl
seo	seo
tsp	tsp
gqd	gqd
ofo	ofo
pxi	pxi
hrv	hrv
tfb	tfb
igf	igf
xey	xey
fyx	fyx
nti	nti
ngz	ngz
xro	xro
hsd	hsd
fec	fec
boc	boc
pqi	pqi
qfn	qfn
lti	lti
btl	btl
kzz	kzz
oaq	oaq
evh	evh
jzj	jzj
uvq	uvq
dks	dks
frp	frp
kbr	kbr
siu	siu
zsr	zsr
nal	nal
evd	evd
wbe	wbe
zqb	zqb
rhw	rhw
kkm	kkm
ztp	ztp
ajg	ajg
djk	djk
utm	utm
lrg	lrg
xpi	xpi
gil	gil
vat	vat
ofi	ofi
pce	pce
pkb	pkb
fxl	fxl
jbm	jbm
mui	mui
ofb	ofb
vnf	vnf
lpp	lpp
spf	spf
adf	adf
ozp	ozp
zag	zag
jyh	jyh
hnk	hnk
hsw	hsw
wwy	wwy
tzz	tzz
zop	zop
aei	aei
jye	jye
cbg	cbg
epm	epm
dcw	dcw
vxu	vxu
kaj	kaj
cqf	cqf
mix	mix
cfn	cfn
wvl	wvl
ylg	ylg
qce	qce
thw	thw
fwf	fwf
luc	luc
yyz	yyz
lzv	lzv
ehf	ehf
qxe	qxe
uui	uui
oyu	oyu
gxk	gxk
bbb	bbb
rng	rng
gjx	gjx
ods	ods
gab	gab
hpy	hpy
ofo	ofo
lmn	lmn
hyi	hyi
dsg	dsg
pvn	pvn
zmb	zmb
ukz	ukz
izw	izw
nmb	nmb
ych	ych
qzx	qzx
otd	otd
yjf	yjf
mbj	mbj
hnk	hnk
zyp	zyp
tet	tet
vev	vev
fbk	fbk
fqk	fqk
kcx	kcx
fih	fih
vyo	vyo
ksh	ksh
tbo	tbo
hqp	hqp
cde	cde
nhf	nhf
ill	ill
whj	whj
rpe	rpe
ahj	ahj
ksr	ksr
cfj	cfj
nel	nel
iyv	iyv
wue	wue
itw	itw
jyp	jyp
thx	thx
mgs	mgs
kuu	kuu
oje	oje
hxa	hxa
nps	nps
yvb	yvb
age	age
fpw	fpw
zgs	zgs
tkd	tkd
npy	npy
gyh	gyh
qjv	qjv
kdq	kdq
vwy	vwy
axq	axq
jrv	jrv
wtg	wtg
qrr	qrr
skx	skx
vna	vna
cbt	cbt
jbd	jbd
azq	azq
rtn	rtn
zif	zif
eup	eup
sjj	sjj
mdh	mdh
yzv	yzv
xdz	xdz
itl	itl
gdt	gdt
obg	obg
wiu	wiu
gnx	gnx
akl	akl
hem	hem
hzj	hzj
htg	htg
pmn	pmn
mdx	mdx
swd	swd
iey	iey
kbe	kbe
snl	snl
lmu	lmu
kxu	kxu
nqd	nqd
pjo	pjo
rce	rce
fzo	fzo
kky	kky
qel	qel
ktz	ktz
hjs	hjs
apl	apl
wyz	wyz
gcd	gcd
jgp	jgp
hqj	hqj
jqn	jqn
ibu	ibu
soa	soa
mws	mws
dwx	dwx
wif	wif
gdm	gdm
abj	abj
fzr	fzr
dmz	dmz
vju	vju
nqe	nqe
wqr	wqr
jvu	jvu
whh	whh
pxx	pxx
vql	vql
hrj	hrj
tlm	tlm
veh	veh
tsr	tsr
etf	etf
nnx	nnx
zuu	zuu
tcm	tcm
pie	pie
ukr	ukr
vbf	vbf
qic	qic
bct	bct
rju	rju
adt	adt
isv	isv
iql	iql
obw	obw
xrf	xrf
zjb	zjb
qeo	qeo
ydt	ydt
fyq	fyq
yez	yez
ryi	ryi
ako	ako
nqd	nqd
kam	kam
ekk	ekk
tnc	tnc
cue	cue
kmt	kmt
gid	gid
new	new
len	len
glq	glq
gef	gef
ydr	ydr
sab	sab
roz	roz
oun	oun
lpo	lpo
umg	umg
gud	gud
xls	xls
rrz	rrz
srg	srg
alq	alq
nob	nob
rkj	rkj
zkf	zkf
ryc	ryc
pvg	pvg
qnd	qnd
idk	idk
nbq	nbq
hjp	hjp
tqz	tqz
gqb	gqb
cnf	cnf
npb	npb
ecc	ecc
bwy	bwy
xdj	xdj
gkj	gkj
bxd	bxd
rse	rse
wam	wam
wka	wka
muo	muo
plr	plr
dne	dne
gqq	gqq
efp	efp
gxe	gxe
dkf	dkf
gjw	gjw
zaz	zaz
lpy	lpy
yio	yio
iup	iup
vnv	vnv
snn	snn
jjk	jjk
vrl	vrl
zqw	zqw
teg	teg
ylf	ylf
zcy	zcy
xat	xat
qfa	qfa
fnk	fnk
zir	zir
zma	zma
glt	glt
jml	jml
jzx	jzx
xze	xze
vtd	vtd
tat	tat
lyu	lyu
iht	iht
erd	erd
qhy	qhy
tgx	tgx
aui	aui
nhn	nhn
jyn	jyn
gsj	gsj
ffo	ffo
umy	umy
vcw	vcw
gjy	gjy
adh	adh
sqa	sqa
aul	aul
oft	oft
oxo	oxo
uch	uch
yrs	yrs
awb	awb
cbd	cbd
ygf	ygf
dco	dco
lcl	lcl
eyf	eyf
njw	njw
llx	llx
phe	phe
nfp	nfp
kbs	kbs
hfk	hfk
ouj	ouj
auf	auf
kdf	kdf
tbo	tbo
qwe	qwe
lzd	lzd
npi	npi
ynp	ynp
mgp	mgp
rmg	rmg
kkr	kkr
krt	krt
jem	jem
pie	pie
pmx	pmx
eug	eug
cyn	cyn
efc	efc
qkt	qkt
ggh	ggh
efc	efc
vbc	vbc
uef	uef
ngj	ngj
rqf	rqf
aqj	aqj
egk	egk
sdl	sdl
boo	boo
fxw	fxw
kxf	kxf
ydy	ydy
zok	zok
lnx	lnx
oyo	oyo
ynj	ynj
zmf	zmf
nlt	nlt
zja	zja
wkw	wkw
kgn	kgn
wrr	wrr
rij	rij
qly	qly
ugq	ugq
yyj	yyj
vtl	vtl
nmy	nmy
dtn	dtn
zcy	zcy
djl	djl
hiq	hiq
sec	sec
tkc	tkc
ulg	ulg
ssj	ssj
grw	grw
nmg	nmg
iyn	iyn
lhf	lhf
mqz	mqz
nbb	nbb
uuq	uuq
iag	iag
nkk	nkk
cit	cit
bdt	bdt
zbn	zbn
inj	inj
bdf	bdf
plv	plv
tvk	tvk
eon	eon
hzd	hzd
ccr	ccr
rme	rme
oww	oww
bwk	bwk
svq	svq
efq	efq
jni	jni
fqk	fqk
kyu	kyu
gfa	gfa
mjw	mjw
osc	osc
nka	nka
ukj	ukj
enk	enk
sxb	sxb
ehe	ehe
juz	juz
pwn	pwn
nwt	nwt
nxd	nxd
rnz	rnz
jzc	jzc
wxh	wxh
wjs	wjs
wug	wug
rux	rux
ewm	ewm
inj	inj
fzq	fzq
jgv	jgv
rjl	rjl
tej	tej
lks	lks
wyy	wyy
gyb	gyb
aef	aef
geu	geu
pso	pso
zeg	zeg
bnr	bnr
hbw	hbw
liw	liw
zgh	zgh
fky	fky
tkq	tkq
ptw	ptw
vkm	vkm
qba	qba
otz	otz
uca	uca
pmp	pmp
bum	bum
enf	enf
rxb	rxb
uzg	uzg
xdo	xdo
yrj	yrj
zaq	zaq
fok	fok
yak	yak
fnf	fnf
cmd	cmd
zxn	zxn
zzs	zzs
kyr	kyr
cdh	cdh
hhu	hhu
wmy	wmy
jvg	jvg
grc	grc
apt	apt
byq	byq
opm	opm
xfc	xfc
tao	tao
quv	quv
psb	psb
xzy	xzy
etd	etd
tjm	tjm
onv	onv
ond	ond
sya	sya
vmb	vmb
hqw	hqw
tzo	tzo
tsq	tsq
ooa	ooa
dha	dha
dam	dam
dsv	dsv
hym	hym
ukn	ukn
ixr	ixr
prf	prf
zxl	zxl
ymn	ymn
prt	prt
faj	faj
gui	gui
uzk	uzk
hir	hir
ytt	ytt
sdt	sdt
bkp	bkp
rrx	rrx
ajg	ajg
yjf	yjf
uqi	uqi
bqs	bqs
yrb	yrb
lli	lli
jug	jug
nfc	nfc
tmu	tmu
ctf	ctf
mje	mje
kkm	kkm
ukv	ukv
odt	odt
swv	swv
bys	bys
nls	nls
zbt	zbt
vfz	vfz
ium	ium
fcs	fcs
kmq	kmq
vyq	vyq
tmu	tmu
cho	cho
pjh	pjh
zky	zky
xiq	xiq
kzs	kzs
vyc	vyc
vkg	vkg
fmb	fmb
dle	dle
atp	atp
pwd	pwd
dfn	dfn
wmb	wmb
dep	dep
apy	apy
ftg	ftg
rsl	rsl
nvg	nvg
fds	fds
tbc	tbc
zrg	zrg
cnw	cnw
zdc	zdc
olt	olt
riq	riq
thq	thq
kdr	kdr
woc	woc
omb	omb
qif	qif
feg	feg
twx	twx
qzc	qzc
wut	wut
swg	swg
wkx	wkx
uup	uup
ahv	ahv
gam	gam
ufq	ufq
eue	eue
bzb	bzb
evg	evg
xdr	xdr
slo	slo
wky	wky
iei	iei
psk	psk
kmp	kmp
cvw	cvw
wuj	wuj
ycf	ycf
joz	joz
vdx	vdx
trm	trm
emy	emy
fyd	fyd
qij	qij
gha	gha
rcd	rcd
khb	khb
aal	aal
uel	uel
nkf	nkf
dnr	dnr
jxl	jxl
dlu	dlu
qoc	qoc
fql	fql
ufj	ufj
xyr	xyr
jmm	jmm
yic	yic
xxt	xxt
abf	abf
rze	rze
gtk	gtk
lug	lug
bhw	bhw
psj	psj
wye	wye
zqb	zqb
gly	gly
wcb	wcb
aty	aty
mgr	mgr
min	min
cpr	cpr
azy	azy
qnl	qnl
ukm	ukm
nez	nez
chu	chu
uvf	uvf
knq	knq
yrm	yrm
awj	awj
cke	cke
dpo	dpo
snv	snv
aie	aie
fis	fis
nsi	nsi
mfe	mfe
xfh	xfh
nhp	nhp
srm	srm
yzf	yzf
avq	avq
ytr	ytr
red	red
caf	caf
ync	ync
dqg	dqg
ggk	ggk
hbh	hbh
vpc	vpc
fpk	fpk
bpe	bpe
dzl	dzl
ltv	ltv
ghp	ghp
ysn	ysn
ncb	ncb
taa	taa
rlh	rlh
ppq	ppq
zku	zku
vve	vve
epd	epd
zpm	zpm
efn	efn
yrn	yrn
wid	wid
dmb	dmb
fln	fln
gkh	gkh
ilw	ilw
fqw	fqw
afe	afe
cwe	cwe
cet	cet
zjq	zjq
olq	olq
mbt	mbt
mfg	mfg
wai	wai
mbp	mbp
vav	vav
rll	rll
jxu	jxu
xlt	xlt
una	una
wai	wai
gfi	gfi
pgr	pgr
cue	cue
jcu	jcu
vxn	vxn
msz	msz
mqe	mqe
sym	sym
skj	skj
lys	lys
bkk	bkk
nfq	nfq
yxn	yxn
nlj	nlj
kff	kff
dkr	dkr
tzb	tzb
ufq	ufq
fod	fod
xmc	xmc
nuv	nuv
svj	svj
lfc	lfc
hrm	hrm
axy	axy
str	str
qrv	qrv
hzs	hzs
edf	edf
hjz	hjz
paf	paf
vbg	vbg
oyp	oyp
vyh	vyh
rsv	rsv
brh	brh
gwt	gwt
dlb	dlb
vks	vks
juu	juu
mda	mda
drv	drv
ipa	ipa
xjo	xjo
prt	prt
ffp	ffp
pgh	pgh
tmx	tmx
hak	hak
fzf	fzf
lwo	lwo
rai	rai
cpo	cpo
eiq	eiq
hvp	hvp
lwq	lwq
sdu	sdu
clj	clj
wuz	wuz
cli	cli
tno	tno
ivf	ivf
sxr	sxr
vmx	vmx
rku	rku
ijm	ijm
ser	ser
ecj	ecj
uri	uri
yzo	yzo
dvn	dvn
gbf	gbf
jmw	jmw
yfw	yfw
bbx	bbx
miu	miu
xaq	xaq
ufu	ufu
byh	byh
cbh	cbh
wvj	wvj
qfa	qfa
evy	evy
clo	clo
kqi	kqi
hbx	hbx
rnn	rnn
iju	iju
ycm	ycm
xnl	xnl
gmu	gmu
kuw	kuw
hgh	hgh
nlk	nlk
xyp	xyp
awd	awd
utx	utx
wsp	wsp
ehp	ehp
vbz	vbz
yjw	yjw
tqs	tqs
shz	shz
ekc	ekc
zfd	zfd
qgm	qgm
cxc	cxc
ono	ono
xgt	xgt
yzr	yzr
vvk	vvk
byh	byh
psd	psd
nwn	nwn
sjf	sjf
aaa	aaa
iyn	iyn
aya	aya
uok	uok
lug	lug
dvo	dvo
ppp	ppp
tvs	tvs
tjg	tjg
pgt	pgt
dqn	dqn
ghw	ghw
vpb	vpb
okq	okq
qyl	qyl
abi	abi
wji	wji
luy	luy
whj	whj
zyl	zyl
obh	obh
exw	exw
ukv	ukv
jmn	jmn
mez	mez
mqm	mqm
hqd	hqd
pmo	pmo
woz	woz
wtk	wtk
flb	flb
hge	hge
hjp	hjp
qgi	qgi
biu	biu
vve	vve
hgn	hgn
jnb	jnb
ikw	ikw
fzb	fzb
rtf	rtf
sgv	sgv
rjb	rjb
wii	wii
fwg	fwg
hpv	hpv
wlv	wlv
dud	dud
cre	cre
egs	egs
too	too
utm	utm
mtw	mtw
ict	ict
rho	rho
icp	icp
khp	khp
qoa	qoa
buh	buh
ifx	ifx
fsv	fsv
wmm	wmm
uwv	uwv
fmz	fmz
ozc	ozc
gle	gle
ete	ete
rwb	rwb
qyj	qyj
enh	enh
awm	awm
ioc	ioc
klz	klz
zyg	zyg
ycc	ycc
ikz	ikz
jcr	jcr
rng	rng
sgm	sgm
fje	fje
gzr	gzr
dku	dku
hqq	hqq
sam	sam
jzr	jzr
glf	glf
dcx	dcx
fhb	fhb
ylp	ylp
wvu	wvu
jss	jss
ccw	ccw
hku	hku
fav	fav
rap	rap
psv	psv
ckd	ckd
pig	pig
hnf	hnf
hzx	hzx
god	god
lov	lov
qce	qce
wue	wue
onz	onz
iks	iks
fja	fja
fvi	fvi
pvg	pvg
aar	aar
cub	cub
ohc	ohc
gki	gki
oel	oel
erh	erh
wse	wse
qja	qja
bpz	bpz
ebf	ebf
snu	snu
zzq	zzq
iti	iti
hxj	hxj
enl	enl
mpj	mpj
glo	glo
jhv	jhv
ypw	ypw
mvy	mvy
prp	prp
sti	sti
bdq	bdq
nrq	nrq
cqc	cqc
hlf	hlf
uab	uab
nuh	nuh
nlt	nlt
jfc	jfc
jnn	jnn
gmb	gmb
ctu	ctu
czl	czl
yem	yem
bww	bww
wkr	wkr
quj	quj
lxn	lxn
qwv	qwv
vmd	vmd
cmo	cmo
zmm	zmm
iqy	iqy
swo	swo
xry	xry
xqd	xqd
bao	bao
vdf	vdf
byf	byf
eql	eql
smk	smk
zkn	zkn
knp	knp
yrw	yrw
suz	suz
lrv	lrv
mql	mql
fag	fag
bpc	bpc
nfw	nfw
csa	csa
udb	udb
qih	qih
lzm	lzm
fro	fro
yao	yao
otw	otw
auu	auu
jdq	jdq
ckm	ckm
eoo	eoo
ycr	ycr
xkg	xkg
nnt	nnt
djz	djz
mwz	mwz
dgf	dgf
vvp	vvp
sdh	sdh
zqu	zqu
yis	yis
mly	mly
sxf	sxf
daj	daj
nhc	nhc
obr	obr
opt	opt
ujo	ujo
uuh	uuh
tuk	tuk
wox	wox
cld	cld
uds	uds
vdk	vdk
qgw	qgw
ohc	ohc
xpt	xpt
zwr	zwr
xzl	xzl
cdb	cdb
qep	qep
yho	yho
hmx	hmx
yci	yci
mht	mht
ptp	ptp
eiw	eiw
kav	kav
qcj	qcj
dge	dge
law	law
jdi	jdi
fiq	fiq
twh	twh
xva	xva
lwo	lwo
psi	psi
kuy	kuy
tnr	tnr
dgt	dgt
ibq	ibq
hmn	hmn
xev	xev
kgx	kgx
cms	cms
htx	htx
xdi	xdi
xqt	xqt
sop	sop
pfb	pfb
thb	thb
zws	zws
kvv	kvv
htn	htn
mcd	mcd
nvo	nvo
dvf	dvf
owm	owm
tst	tst
uqd	uqd
puj	puj
ybu	ybu
xhj	xhj
pek	pek
rxb	rxb
hwg	hwg
cyo	cyo
pfl	pfl
xsh	xsh
lzp	lzp
ijh	ijh
dhr	dhr
jpf	jpf
fea	fea
zxq	zxq
lgy	lgy
tlq	tlq
dkr	dkr
zmt	zmt
tdp	tdp
pxv	pxv
ygm	ygm
jsg	jsg
wsm	wsm
ctu	ctu
ast	ast
vlt	vlt
bry	bry
yig	yig
zpr	zpr
pgx	pgx
lss	lss
wnf	wnf
wzx	wzx
qlg	qlg
ubw	ubw
kjd	kjd
hnk	hnk
bgc	bgc
sgl	sgl
agd	agd
qlz	qlz
zoz	zoz
odz	odz
mio	mio
dyg	dyg
dvu	dvu
hor	hor
egk	egk
mfi	mfi
hga	hga
axe	axe
bai	bai
tue	tue
mgm	mgm
gbz	gbz
wyk	wyk
pch	pch
lig	lig
svn	svn
fqk	fqk
pdg	pdg
wdy	wdy
ejs	ejs
wlf	wlf
yzl	yzl
oda	oda
kqa	kqa
duu	duu
hvu	hvu
cbt	cbt
niy	niy
tlf	tlf
ziu	ziu
snz	snz
iib	iib
nvf	nvf
kiv	kiv
qoh	qoh
yss	yss
mim	mim
wht	wht
vcl	vcl
rpe	rpe
vgq	vgq
ygw	ygw
zkd	zkd
btp	btp
nmw	nmw
isw	isw
ndo	ndo
yfp	yfp
ume	ume
lhj	lhj
zuo	zuo
jss	jss
ngq	ngq
vir	vir
xom	xom
tys	tys
rjg	rjg
eyr	eyr
yqu	yqu
hgu	hgu
xnl	xnl
gwi	gwi
zpa	zpa
stk	stk
kfj	kfj
ecs	ecs
aop	aop
gnb	gnb
ujl	ujl
fcu	fcu
xtd	xtd
xij	xij
oad	oad
ztm	ztm
lit	lit
dud	dud
acg	acg
sge	sge
hku	hku
uyz	uyz
vzt	vzt
gol	gol
axi	axi
znr	znr
vcx	vcx
xrh	xrh
eat	eat
wxk	wxk
mwy	mwy
gge	gge
kde	kde
eyo	eyo
cbq	cbq
hep	hep
pph	pph
bil	bil
crz	crz
vfx	vfx
tgg	tgg
omv	omv
syq	syq
uke	uke
wga	wga
aoe	aoe
yjj	yjj
ajq	ajq
kwa	kwa
kqe	kqe
fmf	fmf
jum	jum
rai	rai
vsb	vsb
qhq	qhq
bfo	bfo
jaq	jaq
lxj	lxj
dqt	dqt
msy	msy
vjr	vjr
yxu	yxu
aiq	aiq
jch	jch
gqn	gqn
anl	anl
nme	nme
jgz	jgz
xfj	xfj
wun	wun
vdg	vdg
ozq	ozq
oyd	oyd
uac	uac
goy	goy
ifi	ifi
txa	txa
fbt	fbt
qop	qop
fqa	fqa
xmm	xmm
qpz	qpz
fmi	fmi
mbj	mbj
ljk	ljk
api	api
ahi	ahi
lzs	lzs
adf	adf
yiq	yiq
aoh	aoh
uet	uet
qsf	qsf
wdn	wdn
avp	avp
vbs	vbs
iab	iab
msw	msw
hqr	hqr
uhb	uhb
bfx	bfx
phu	phu
obu	obu
czg	czg
lph	lph
yxv	yxv
rof	rof
zhj	zhj
wwu	wwu
xjk	xjk
rsr	rsr
fic	fic
zaf	zaf
yhz	yhz
jut	jut
mqv	mqv
yrl	yrl
dcc	dcc
erf	erf
zaj	zaj
htd	htd
jzp	jzp
xib	xib
hwg	hwg
akh	akh
eys	eys
yhw	yhw
qhr	qhr
lco	lco
mjk	mjk
asn	asn
cjo	cjo
fpk	fpk
ema	ema
ctv	ctv
yrf	yrf
mwm	mwm
wwm	wwm
awe	awe
ygi	ygi
xvx	xvx
srb	srb
trw	trw
pbg	pbg
vbx	vbx
kxb	kxb
xvf	xvf
vqm	vqm
hwv	hwv
ajj	ajj
epj	epj
ubf	ubf
dvx	dvx
xzq	xzq
doq	doq
lhv	lhv
sze	sze
reo	reo
lbu	lbu
pdy	pdy
adn	adn
taw	taw
mzy	mzy
wbf	wbf
smw	smw
ceb	ceb
yzz	yzz
uhi	uhi
hox	hox
nkz	nkz
ofr	ofr
hmy	hmy
kzv	kzv
ane	ane
gld	gld
gkm	gkm
yos	yos
jdz	jdz
vtq	vtq
kby	kby
vde	vde
qqp	qqp
yfp	yfp
rpl	rpl
wnv	wnv
ely	ely
trh	trh
nuf	nuf
oiz	oiz
srr	srr
teh	teh
qfd	qfd
izq	izq
xjl	xjl
kzx	kzx
ebx	ebx
nwc	nwc
kaz	kaz
vst	vst
hwr	hwr
vfd	vfd
gpp	gpp
fgl	fgl
zyo	zyo
lva	lva
mov	mov
yez	yez
wbu	wbu
hwi	hwi
nqs	nqs
ymz	ymz
tsl	tsl
rks	rks
lnp	lnp
izx	izx
ypt	ypt
myu	myu
ssz	ssz
bgx	bgx
jdp	jdp
pab	pab
gnz	gnz
ntk	ntk
mdv	mdv
emf	emf
gzu	gzu
cec	cec
wjo	wjo
qod	qod
bbd	bbd
vdv	vdv
gna	gna
pdz	pdz
puf	puf
glf	glf
onc	onc
gxm	gxm
uuy	uuy
xgv	xgv
cgi	cgi
vjs	vjs
ino	ino
snb	snb
hid	hid
dqo	dqo
gyl	gyl
wgg	wgg
aen	aen
auy	auy
ayd	ayd
vag	vag
jch	jch
eud	eud
xah	xah
fwv	fwv
zxd	zxd
zow	zow
zoo	zoo
qfo	qfo
vrx	vrx
jzo	jzo
tms	tms
tom	tom
msu	msu
bwv	bwv
ujo	ujo
jaf	jaf
jdy	jdy
cpz	cpz
zhs	zhs
shf	shf
fxj	fxj
mqe	mqe
btk	btk
xhb	xhb
eeo	eeo
sif	sif
eme	eme
rzu	rzu
wru	wru
dnt	dnt
ony	ony
zkd	zkd
zgu	zgu
ycf	ycf
wpw	wpw
snw	snw
cqq	cqq
dhu	dhu
lll	lll
mcz	mcz
gzg	gzg
ssw	ssw
uig	uig
pzo	pzo
eha	eha
mnj	mnj
swu	swu
yvr	yvr
wyn	wyn
qwb	qwb
ahk	ahk
zgv	zgv
lfa	lfa
hks	hks
oug	oug
ytp	ytp
nug	nug
ovm	ovm
hop	hop
ndq	ndq
dkg	dkg
tew	tew
ivw	ivw
fru	fru
